        *                     9                                                                                                                                                   9
        *
#       *                                                                                                                                                                                                                                  *      #
#       *  @                                                                                              777777     77               7             7      77                                                                              *      #
#       *                                     7                                                          3######4   3##4              5            3#4    3##4                                                        12                   *      #
#       *                                     5                                                                                                                                                                      100                   *      #
#       *           9                                                                                                                                                                                               1000                   *      #
#       *                               7                                                                                                                                                                          10000             ###   *      #
#       *                               5   3###4      7777           12                              3#4              5     34    5  5  5     5         9 34     1  2          12  12            3##4            100000             ###   *      #
#       *                                                     12      00         12                                                                              10  02        100  002                          1000000            #####  *      #
#       *                                           12        00      00         00        9                                                                    100  002      1000  0002     12              12 10000000            #####  *      #
#       *        #              8                   00        00   8  00     8   00                                                                            1000  0002    10000  00002    00      8       00000000000   8    5   #####  *      #
####################################################00########00######00#########00##########  ################   #############################################0000  0000####00000  00000####00##############00000000000########0###################
000000000000000000000000000000000000000000000000000000000000000000000000000000000000000000000  0000000000000000   0000000000000000000000000000000000000000000000000  0000000000000  0000000000000000000000000000000000000000000000000000000000000000
6666666666666666666666666666666666666666666666666666666666666666666666666666666666666666666666666666666666666666666666666666666666666666666666666666666666666666666666666666666666666666666666666666666666666666666666666666666666666666666666666666
####################################################################################################################################################################################################################################################
####################################################################################################################################################################################################################################################
####################################################################################################################################################################################################################################################