...###..##.#.#.#.#
..#........#....#.
.#..###..#..###.#.
##.#####..#..##.#
#...@..####.....#
#.#..###..#.#####
#.####......#
#......######